1111111111111111111111111111111111111111111111111111111111111111
1000000000000000000000000000000000000000000000000000000000000001
1011111111111111111111111111111C00000000000000000000000000000001
1000000000000000000000000000001C00000000000000000000000000000001
1111111111111111111111111111101C00000000000000000000000000000001
1000000000000000000000000000001C00000000000000000000000000000001
1011111111111111111111111111111C00000000000000000000000000000001
1000000000000000000000000000001C00000000000000000000000000000001
1111111111111111111111111111101C00000000000000000000000000000001
1000000000000000000000000000001C00000000000000000000000000000001
1011111111111111111111111111111C00000000000000000000000000000001
1000000000000000000000000000001C00000000000000000000000000000001
1111111111111111111111111111101C00000000000000000000000000000001
1000000000000000000000000000001C00000000000000000000000000000001
1011111111111111111111111111111C00000000000000000000000000000001
1000000000000000000000000000001C00000000000000000000000000000001
1111111111111111111111111111101C00000000000000000000000000000001
1000000000000000000000000000001C00000000000000000000000000000001
1011111111111111111111111111111C00000000000000000000000000000001
1000000000000000000000000000001C00000000000000000000000000000001
1111111111111111111111111111101C00000000000000000000000000000001
1000000000000000000000000000001C00000000000000000000000000000001
1011111111111111111111111111111C00000000000000000000000000000001
1000000000000000000000000000001C00000000000000000000000000000001
1111111111111111111111111111101C00000000000000000000000000000001
1000000000000000000000000000001C00000000000000000000000000000001
1011111111111111111111111111111C00000000000000000000000000000001
1000000000000000000000000000001C00000000000000000000000000000001
1111111111111111111111111111101C00000000000000000000000000000001
1000000000000000000000000000001C00000000000000000000000000000001
1011111111111111111111111111111C00000000000000000000000000000001
1000000000000000000000000000001C00000000000000000000000000000001
1111111111111111111111111111101C00000000000000000000000000000001
1000000000000000000000000000001C00000000000000000000000000000001
1011111111111111111111111111111C00000000000000000000000000000001
1000000000000000000000000000001C00000000000000000000000000000001
1111111111111111111111111111101C00000000000000000000000000000001
1000000000000000000000000000001C00000000000000000000000000000001
1011111111111111111111111111111C00000000000000000000000000000001
1000000000000000000000000000001C00000000000000000000000000000001
1111111111111111111111111111101C00000000000000000000000000000001
1000000000000000000000000000001C00000000000000000000000000000001
1011111111111111111111111111111C00000000000000000000000000000001
1000000000000000000000000000001C00000000000000000000000000000001
1111111111111111111111111111101C00000000000000000000000000000001
1000000000000000000000000000001C00000000000000000000000000000001
1011111111111111111111111111111C00000000000000E00000000000000001
10000000000000000000000000000P1C00000000000000000000000000000001
1111111111111111111111111111111111111111111111111111111111111111